14 14
15 15
..............................
..........X........X..........
....X.................X.......
.X................X...........
.........X................X...
.............X..........X.....
...X.......................X..
........X...........X.........
...........X.....X............
.....X.................X......
..X..................X........
......X.....................X.
............X...X.............
.......X.................X....
..............................
..............................
....X.................X.......
.............X...X............
.X.....................X......
........X..................X..
......X.................X.....
............X.....X...........
.........X...........X........
..X.......................X...
.....X..........X.............
...X................X.........
...........X................X.
.......X.................X....
..........X........X..........
..............................
